Chatou	isLocatedIn	France
Boo_Young-tae	playsFor	Yangju_Citizen_FC
Toni_Kuivasto	isAffiliatedTo	Helsingin_Jalkapalloklubi
Josh_Smith_(soccer)	playsFor	Trinity_University_(Texas)
Albrecht_Dürer	diedIn	Nuremberg
Edwin_Holliday	isAffiliatedTo	Hereford_United_F.C.
William_Hopper	actedIn	The_Bad_Seed_(1956_film)
Eric_Maskin	graduatedFrom	Harvard_University
George_Mallia	playsFor	Malta_national_football_team
Héctor_Cúper	isAffiliatedTo	Aris_Thessaloniki_F.C.
Peter_Creamer	wasBornIn	Hartlepool
Robert_Bly	hasGender	male
Bangalore_Urban_district	isLocatedIn	Karnataka
Benedict_Iroha	isAffiliatedTo	D.C._United
Ariel_Garcé	playsFor	Rosario_Central
Trevor_Senior	playsFor	Dorchester_Town_F.C.
Joe_Roberts	actedIn	Our_Hospitality
Emanuele_Concetti	playsFor	U.S._Pergolettese_1932
Warren_Bradley_(footballer)	playsFor	Macclesfield_Town_F.C.
Simone_Zaza	playsFor	F.C._Esperia_Viareggio
Tom_Kouzmanis	isAffiliatedTo	York_Region_Shooters
Ricardo_Moniz	playsFor	Helmond_Sport
László_Sternberg	playsFor	New_York_Americans_(soccer)
Charlie_Chaplin	actedIn	Caught_in_a_Cabaret
Lee_Clarke	playsFor	Northern_Ireland_national_under-21_football_team
Jason_Matthews_(footballer)	isAffiliatedTo	Aberystwyth_Town_F.C.
Alan_Ainscow	isAffiliatedTo	Everton_F.C.
Antoine_Bonifaci	isAffiliatedTo	Bologna_F.C._1909
Patrick_Colleter	isAffiliatedTo	AS_Cannes
Nicola_Sansone	playsFor	Parma_F.C.
Edgardo_Abdala	playsFor	Huachipato
Júnior_Maranhão	playsFor	Club_Sportivo_Sergipe
Xavier_Hochstrasser	playsFor	Calcio_Padova
Karl_Munroe	isAffiliatedTo	Droylsden_F.C.
Joelson_Santos_Silva	isAffiliatedTo	Santa_Cruz_Futebol_Clube
Giuseppe_Viani	wasBornIn	Treviso
Georgi_Kondratiev	isAffiliatedTo	FC_Dinamo_Brest
Dragan_Lukovski	isAffiliatedTo	BC_Kyiv
Abderraouf_Zarabi	isAffiliatedTo	JS_Kabylie
Bruce_County	isLocatedIn	Ontario
Sam_Hewson	isAffiliatedTo	Manchester_United_F.C.
Alan_Miller_(footballer)	isAffiliatedTo	England_national_under-21_football_team
Frédéric_Roux	hasGender	male
Nils_Petersen	playsFor	FC_Carl_Zeiss_Jena
Serigne_Diop	playsFor	PAEEK
Arthur_Sorin	playsFor	Stade_Rennais_F.C.
Gmina_Widawa	isLocatedIn	Łask_County
Albert_Jorquera	playsFor	AD_Ceuta
Remington_Arms	isLocatedIn	Madison,_North_Carolina
Pedro_Jorge_Santos_Santos	isAffiliatedTo	Gil_Vicente_F.C.
Scott_Wagstaff	isAffiliatedTo	A.F.C._Bournemouth
Battle_of_Verneuil	happenedIn	Kingdom_of_England
Mark_Jackson_(footballer)	isAffiliatedTo	Leeds_United_A.F.C.
John_Benson_(footballer)	isAffiliatedTo	Wigan_Athletic_F.C.
Liburd_Henry	isAffiliatedTo	Bromley_F.C.
Pedro_Antonio_Vega_Rodríguez	isAffiliatedTo	Spain_national_under-20_football_team
Willie_Sims_(footballer)	playsFor	San_Fernando_Valley_Quakes
Joe_Simitian	graduatedFrom	Stanford_University
Eric_Rapo	isAffiliatedTo	CS_Chênois
Chic_Charnley	playsFor	Portadown_F.C.
Pablo_Granoche	playsFor	Tiburones_Rojos_de_Coatzacoalcos
Anderson_Ribeiro_Pereira	playsFor	Sport_Club_Corinthians_Paulista
Terry_Woodberry	isAffiliatedTo	Chelsea_F.C.
Glen_Crowe	playsFor	Plymouth_Argyle_F.C.
Maheta_Molango	isAffiliatedTo	UB_Conquense
Bradley_Cooper	actedIn	Wedding_Crashers
Vladimir_Fock	hasGender	male
O._W._Fischer	playsFor	Hartlepool_United_F.C.
Jesús_Garay	isAffiliatedTo	Athletic_Bilbao
Marcelo_Goianira	isAffiliatedTo	Panthrakikos_F.C.
Mike_Scott_(musician)	hasMusicalRole	wordnet_guitar_103467517
Emil_Sitka	actedIn	Fuelin'_Around
Ajaccio_Napoleon_Bonaparte_Airport	isConnectedTo	Toulouse–Blagnac_Airport
Helgi_Daníelsson	isAffiliatedTo	C.F._Os_Belenenses
Nenad_Đorđević	playsFor	FK_Obilić
Dylan_Hughes	hasGender	male
Michal_Nehoda	playsFor	SK_Hanácká_Slavia_Kroměříž
Albert_Duro	hasGender	male
Dave_McEachran	playsFor	Boston_Bears_(soccer)
Lal_Bahadur_Shastri_Airport	isConnectedTo	Visakhapatnam_Airport
Giuliano_Oliviero	isAffiliatedTo	Milwaukee_Wave_United
George_Karl	isAffiliatedTo	Golden_State_Warriors
Juan_Pablo_Sorín	playsFor	Cruzeiro_Esporte_Clube
Rui_Fernando_Nascimento_Borges	hasGender	male
Esteban_Cambiasso	playsFor	Argentina_national_football_team
Stephan_Marasek	isAffiliatedTo	FC_Swarovski_Tirol
Joe_Benjamin_(footballer)	isAffiliatedTo	Boreham_Wood_F.C.
Mary,_Queen_of_Hungary	isMarriedTo	Jobst_of_Moravia
Adam_Haywood	playsFor	Arsenal_F.C.
Hans_Krankl	playsFor	FC_Red_Bull_Salzburg
Theodor_Meynert	graduatedFrom	University_of_Vienna
Nicolás_Medina	isAffiliatedTo	Club_de_Gimnasia_y_Esgrima_La_Plata
Rahul_Dev	actedIn	Aadhavan
Clemens_August_Graf_von_Galen	playsFor	FC_Zirka_Kirovohrad
Lord's_Resistance_Army_insurgency	happenedIn	Uganda
Mariusz_Mowlik	playsFor	ŁKS_Łódź
Petit	hasGender	male
Gmina_Osiek,_Kuyavian-Pomeranian_Voivodeship	isLocatedIn	Kuyavian-Pomeranian_Voivodeship
Ángel_Puertas	isAffiliatedTo	San_Martín_de_San_Juan
İsmail_Özgür_Göktaş	playsFor	Tarsus_Idman_Yurdu
